0000000000000000000000000000000000000000
0..(F)..GUARDIAO.......................0
0....(O)...............................0
0......................................0
0.....CUIDADO COM OS OBSTACULOS........0
0......................................0
0.................(F)..................0
0......................................0
0..(C).................................0
0000000000000000000000000000000000000000